//MAP CONVERTED BY dmm2tgm.py THIS HEADER COMMENT PREVENTS RECONVERSION, DO NOT REMOVE
"a" = (
/turf/open/floor/rogue/naturalstone,
/area/rogue/indoors/warcamp/outskirts/cave)
"d" = (
/turf/open/floor/rogue/naturalstone{
	color = "#b9b9b9"
	},
/area/rogue/indoors/warcamp/outskirts/cave)
"e" = (
/turf/open/floor/rogue/cobblerock,
/area/rogue/indoors/warcamp/outskirts/cave)
"f" = (
/turf/closed/wall/mineral/rogue/wooddark,
/area/rogue/indoors/warcamp/outskirts/cave)
"o" = (
/obj/effect/decal/cobbleedge{
	dir = 8;
	icon_state = "borderfall"
	},
/turf/open/floor/rogue/naturalstone{
	color = "#b9b9b9"
	},
/area/rogue/indoors/warcamp/outskirts/cave)
"v" = (
/obj/effect/decal/cobbleedge{
	dir = 4;
	icon_state = "borderfall"
	},
/turf/open/floor/rogue/naturalstone{
	color = "#b9b9b9"
	},
/area/rogue/indoors/warcamp/outskirts/cave)
"w" = (
/obj/structure/fluff/traveltile/warband/outskirts_to_camp,
/turf/open/floor/rogue/naturalstone,
/area/rogue/indoors/warcamp/outskirts/cave)
"A" = (
/obj/effect/decal/cobbleedge{
	dir = 2;
	icon_state = "borderfall"
	},
/turf/open/floor/rogue/naturalstone{
	color = "#b9b9b9"
	},
/area/rogue/indoors/warcamp/outskirts/cave)
"C" = (
/obj/effect/decal/cobbleedge{
	dir = 4;
	icon_state = "borderfall"
	},
/turf/open/floor/rogue/naturalstone,
/area/rogue/indoors/warcamp/outskirts/cave)
"D" = (
/obj/machinery/light/rogue/torchholder,
/turf/closed/wall/mineral/rogue/wooddark,
/area/rogue/indoors/warcamp/outskirts/cave)
"G" = (
/obj/effect/decal/cobbleedge{
	dir = 8;
	icon_state = "borderfall"
	},
/turf/open/floor/rogue/naturalstone,
/area/rogue/indoors/warcamp/outskirts/cave)
"H" = (
/turf/closed/mineral/rogue/bedrock,
/area/rogue/indoors/warcamp/outskirts/cave)
"K" = (
/obj/effect/decal/cobbleedge{
	dir = 1;
	icon_state = "borderfall"
	},
/turf/open/floor/rogue/naturalstone{
	color = "#b9b9b9"
	},
/area/rogue/indoors/warcamp/outskirts/cave)
"P" = (
/obj/effect/baseturf_helper,
/turf/closed/mineral/rogue/bedrock,
/area/rogue/indoors/warcamp/outskirts/cave)
"U" = (
/obj/structure/fluff/traveltile/warband/outskirts_to_intermission,
/turf/open/floor/rogue/cobblerock,
/area/rogue/indoors/warcamp/outskirts/cave)

(1,1,1) = {"
H
H
H
H
H
H
H
H
H
H
H
H
H
H
H
H
H
H
H
H
H
H
H
H
H
H
H
H
H
H
H
H
H
H
H
H
H
H
U
U
U
U
U
H
H
"}
(2,1,1) = {"
H
H
H
H
H
H
H
H
H
H
H
H
H
H
H
H
H
H
H
H
H
H
H
H
H
H
H
H
H
H
H
H
H
H
H
D
K
d
e
e
e
e
e
H
H
"}
(3,1,1) = {"
H
H
H
H
H
H
H
H
H
H
H
H
H
H
H
H
H
H
H
H
H
H
H
H
H
H
H
H
H
H
H
H
H
H
d
o
d
a
e
e
e
e
e
H
H
"}
(4,1,1) = {"
H
H
H
H
H
H
H
H
H
H
H
H
H
H
H
H
H
H
H
H
H
H
H
H
H
H
H
H
H
H
H
H
d
d
d
a
a
a
a
e
e
e
d
H
H
"}
(5,1,1) = {"
H
H
H
H
H
H
H
H
H
H
H
H
H
H
H
H
H
H
H
H
H
H
H
H
H
H
H
H
H
H
H
d
d
a
a
a
a
a
a
a
a
d
H
H
H
"}
(6,1,1) = {"
H
H
H
H
H
H
H
H
H
D
K
d
d
d
A
D
H
H
H
H
H
H
H
H
H
H
H
H
H
H
d
d
a
a
H
a
a
a
e
e
a
d
H
H
H
"}
(7,1,1) = {"
H
H
H
H
H
H
H
H
d
o
a
a
a
a
a
o
d
d
H
H
H
H
H
H
H
H
H
H
H
d
d
a
a
H
H
a
a
e
e
a
a
a
d
d
H
"}
(8,1,1) = {"
H
H
H
H
H
H
H
d
d
a
a
a
a
a
a
a
a
d
d
H
H
H
H
H
H
H
H
H
d
a
a
a
a
H
H
a
a
e
a
a
a
a
d
H
H
"}
(9,1,1) = {"
H
H
H
H
H
H
d
a
a
a
a
a
a
a
e
a
a
a
d
d
d
H
H
H
H
H
H
d
d
a
a
a
H
H
a
a
a
a
a
a
d
v
d
H
H
"}
(10,1,1) = {"
H
H
H
H
H
d
a
a
a
a
e
a
e
a
e
e
a
a
a
a
d
A
D
H
H
H
H
d
d
a
a
H
H
H
a
e
e
a
a
d
A
D
H
H
H
"}
(11,1,1) = {"
H
H
H
H
d
d
a
a
e
a
e
e
e
a
e
e
a
e
e
a
a
d
o
H
H
H
H
H
d
a
a
H
H
a
a
e
a
a
d
d
H
H
H
H
H
"}
(12,1,1) = {"
H
H
H
D
d
a
e
a
a
a
a
a
a
a
a
a
a
a
e
e
e
a
d
d
H
H
H
H
d
d
a
a
a
a
a
a
a
d
d
H
H
H
H
H
H
"}
(13,1,1) = {"
H
H
d
o
a
e
e
a
a
d
d
d
d
d
d
v
a
a
a
e
e
a
a
d
A
f
H
H
H
d
v
a
a
a
a
a
a
d
d
H
H
H
H
H
H
"}
(14,1,1) = {"
H
H
d
a
e
e
a
d
d
d
H
H
H
H
H
D
K
d
d
a
a
a
e
a
a
o
d
H
H
H
D
K
d
a
a
e
a
d
d
A
D
H
H
H
H
"}
(15,1,1) = {"
H
H
d
a
a
a
a
d
H
H
H
H
H
H
H
H
H
H
d
d
d
a
a
e
a
a
d
d
H
H
H
H
d
d
a
e
e
a
d
d
o
H
H
H
H
"}
(16,1,1) = {"
H
H
d
a
e
e
a
d
d
H
H
H
H
H
H
H
H
H
H
H
d
d
d
a
a
e
a
d
d
H
H
H
H
d
d
a
e
a
a
d
d
d
H
H
H
"}
(17,1,1) = {"
H
H
d
a
e
e
a
a
d
d
H
H
H
H
H
H
H
H
H
H
H
d
v
d
a
a
e
a
d
A
D
H
H
H
d
d
a
a
a
a
a
A
f
H
H
"}
(18,1,1) = {"
H
H
d
a
a
a
a
a
a
d
d
H
H
H
H
H
H
H
H
H
H
H
D
K
d
a
e
e
a
d
o
H
H
H
H
d
d
a
e
e
a
d
o
H
H
"}
(19,1,1) = {"
H
H
d
a
e
a
a
a
a
a
d
d
d
A
D
H
H
H
H
H
H
H
H
H
d
d
a
e
e
a
d
d
H
H
H
H
d
a
a
e
a
d
A
D
H
"}
(20,1,1) = {"
H
H
d
a
e
e
a
a
a
a
a
a
a
a
G
a
w
H
H
H
H
H
H
H
H
d
a
a
e
a
a
d
A
f
H
H
H
d
d
a
a
d
d
H
H
"}
(21,1,1) = {"
H
H
d
a
a
a
a
a
a
a
a
e
a
e
a
a
a
w
H
H
H
H
H
H
H
d
d
a
a
a
a
a
d
o
H
H
H
H
d
a
a
a
d
H
H
"}
(22,1,1) = {"
H
H
d
d
a
a
e
e
a
a
a
a
a
a
a
a
a
w
H
H
H
H
H
H
H
H
v
d
a
a
e
a
a
d
d
H
H
H
d
a
e
a
d
H
H
"}
(23,1,1) = {"
H
H
d
d
a
a
a
a
e
e
a
a
a
a
a
a
a
a
w
H
H
H
H
H
H
H
f
K
a
a
e
e
a
a
d
A
D
H
d
e
e
a
A
D
H
"}
(24,1,1) = {"
H
H
H
d
v
a
a
a
a
a
a
a
e
a
a
a
a
a
w
H
H
H
H
H
H
H
H
d
a
a
a
e
e
a
a
d
o
d
d
e
a
d
d
H
H
"}
(25,1,1) = {"
H
H
H
H
D
d
a
a
a
a
a
a
a
a
a
e
a
a
w
H
H
H
H
H
H
H
H
d
d
a
a
a
e
e
a
a
a
a
e
e
a
d
H
H
H
"}
(26,1,1) = {"
H
H
H
H
H
d
d
a
a
a
a
e
a
a
a
e
a
a
w
H
H
H
H
H
H
H
H
H
d
d
a
a
a
e
a
a
a
e
e
a
d
v
H
H
H
"}
(27,1,1) = {"
H
H
H
H
H
H
H
d
v
a
a
a
a
a
a
C
e
H
H
H
H
H
H
H
H
H
H
H
H
d
v
d
a
a
a
a
a
a
a
d
A
D
H
H
H
"}
(28,1,1) = {"
H
H
H
H
H
H
H
H
D
K
d
d
d
d
A
D
H
H
H
H
H
H
H
H
H
H
H
H
H
H
D
K
d
d
d
d
v
d
d
d
H
H
H
H
H
"}
(29,1,1) = {"
H
H
H
H
H
H
H
H
H
H
H
H
H
H
H
H
H
H
H
H
H
H
H
H
H
H
H
H
H
H
H
H
H
H
H
H
D
H
H
H
H
H
H
H
H
"}
(30,1,1) = {"
P
H
H
H
H
H
H
H
H
H
H
H
H
H
H
H
H
H
H
H
H
H
H
H
H
H
H
H
H
H
H
H
H
H
H
H
H
H
H
H
H
H
H
H
H
"}
