//MAP CONVERTED BY dmm2tgm.py THIS HEADER COMMENT PREVENTS RECONVERSION, DO NOT REMOVE
"a" = (
/turf/open/floor/rogue/grasscold,
/area/rogue/outdoors/warcamp/outskirts/decap)
"b" = (
/obj/structure/fluff/railing/border/west,
/obj/machinery/light/roguestreet{
	pixel_y = 11;
	pixel_x = -8;
	dir = 1
	},
/turf/open/floor/rogue/metal/barograte,
/area/rogue/outdoors/warcamp/outskirts/decap)
"c" = (
/obj/structure/flora/roguegrass/pyroclasticflowers,
/turf/open/floor/rogue/dirt,
/area/rogue/outdoors/warcamp/outskirts/decap)
"d" = (
/obj/structure/flora/hotspring_rocks/small/two,
/turf/open/floor/rogue/grasscold,
/area/rogue/outdoors/warcamp/outskirts/decap)
"e" = (
/obj/machinery/light/roguestreet{
	pixel_y = 11;
	pixel_x = 8
	},
/turf/open/floor/rogue/metal/barograte,
/area/rogue/outdoors/warcamp/outskirts/decap)
"f" = (
/obj/structure/flora/roguetree/pine,
/turf/open/floor/rogue/snow,
/area/rogue/outdoors/warcamp/outskirts/decap)
"g" = (
/turf/closed/mineral/rogue/bedrock,
/area/rogue/outdoors/warcamp/outskirts/decap)
"h" = (
/obj/structure/fluff/railing/border/east,
/turf/open/floor/rogue/grasscold,
/area/rogue/outdoors/warcamp/outskirts/decap)
"i" = (
/obj/structure/fluff/railing/border/east,
/obj/machinery/light/roguestreet{
	pixel_y = 11;
	pixel_x = 8
	},
/turf/open/floor/rogue/metal/barograte,
/area/rogue/outdoors/warcamp/outskirts/decap)
"j" = (
/obj/structure/flora/roguetree/pine/dead,
/turf/open/floor/rogue/dirt,
/area/rogue/outdoors/warcamp/outskirts/decap)
"k" = (
/obj/structure/fluff/railing/border/west,
/turf/open/floor/rogue/grasscold,
/area/rogue/outdoors/warcamp/outskirts/decap)
"l" = (
/obj/effect/baseturf_helper,
/turf/closed/mineral/rogue/bedrock,
/area/rogue/outdoors/warcamp/outskirts/decap)
"m" = (
/obj/structure/fluff/railing/border/west,
/turf/open/floor/rogue/metal/barograte,
/area/rogue/outdoors/warcamp/outskirts/decap)
"n" = (
/obj/structure/fluff/statue/knight{
	pixel_x = -10
	},
/turf/open/floor/rogue/metal/barograte,
/area/rogue/outdoors/warcamp/outskirts/decap)
"o" = (
/obj/item/roguecoin/aalloy/pile,
/turf/open/floor/rogue/dirt/road,
/area/rogue/outdoors/warcamp/outskirts/decap)
"p" = (
/obj/effect/decal/cobbleedge{
	dir = 8;
	icon_state = "borderfall"
	},
/turf/open/floor/rogue/dirt/road,
/area/rogue/outdoors/warcamp/outskirts/decap)
"q" = (
/obj/item/reagent_containers/food/snacks/crow{
	dir = 4
	},
/turf/open/floor/rogue/dirt/road,
/area/rogue/outdoors/warcamp/outskirts/decap)
"r" = (
/turf/closed/mineral/rogue/bedrock,
/area/rogue/indoors/warcamp/outskirts/decap)
"s" = (
/turf/open/lava,
/area/rogue/outdoors/warcamp/outskirts/decap)
"t" = (
/obj/structure/flora/hotspring_rocks/grassy,
/turf/open/floor/rogue/grasscold,
/area/rogue/outdoors/warcamp/outskirts/decap)
"u" = (
/obj/structure/fluff/traveltile/warband/outskirts_to_camp,
/turf/open/floor/rogue/dirt/road,
/area/rogue/outdoors/warcamp/outskirts/decap)
"v" = (
/obj/structure/flora/roguegrass,
/turf/open/floor/rogue/grasscold,
/area/rogue/outdoors/warcamp/outskirts/decap)
"w" = (
/obj/structure/fluff/railing/border{
	dir = 9
	},
/turf/open/floor/rogue/dirt/road,
/area/rogue/outdoors/warcamp/outskirts/decap)
"x" = (
/obj/structure/flora/hotspring_rocks/small/two{
	pixel_x = 7;
	pixel_y = -12
	},
/obj/structure/flora/hotspring_rocks/small/five,
/turf/open/floor/rogue/grasscold,
/area/rogue/outdoors/warcamp/outskirts/decap)
"y" = (
/obj/structure/flora/hotspring_rocks/small/five,
/turf/open/floor/rogue/grasscold,
/area/rogue/outdoors/warcamp/outskirts/decap)
"z" = (
/obj/structure/fluff/railing/border/east,
/obj/structure/flora/roguegrass,
/turf/open/floor/rogue/grasscold,
/area/rogue/outdoors/warcamp/outskirts/decap)
"A" = (
/turf/open/floor/rogue/dirt/road,
/area/rogue/outdoors/warcamp/outskirts/decap)
"B" = (
/obj/structure/fluff/statue/knight/r{
	pixel_x = 9
	},
/turf/open/floor/rogue/metal/barograte,
/area/rogue/outdoors/warcamp/outskirts/decap)
"C" = (
/obj/structure/fluff/traveltile/warband/outskirts_to_camp,
/turf/open/floor/rogue/cobblerock,
/area/rogue/outdoors/warcamp/outskirts/decap)
"D" = (
/turf/open/floor/rogue/snow,
/area/rogue/outdoors/warcamp/outskirts/decap)
"E" = (
/turf/open/floor/rogue/cobblerock,
/area/rogue/outdoors/warcamp/outskirts/decap)
"F" = (
/obj/structure/fluff/railing/border/west,
/obj/structure/flora/roguegrass,
/turf/open/floor/rogue/grasscold,
/area/rogue/outdoors/warcamp/outskirts/decap)
"G" = (
/obj/effect/decal/cobbleedge{
	dir = 4;
	icon_state = "borderfall"
	},
/turf/open/floor/rogue/dirt/road,
/area/rogue/outdoors/warcamp/outskirts/decap)
"H" = (
/obj/machinery/light/rogue/firebowl/church,
/turf/open/floor/rogue/church,
/area/rogue/outdoors/warcamp/outskirts/decap)
"I" = (
/obj/machinery/light/roguestreet/midlamp,
/turf/open/floor/rogue/metal/barograte/open,
/area/rogue/outdoors/warcamp/outskirts/decap)
"J" = (
/obj/item/reagent_containers/food/snacks/crow{
	dir = 8
	},
/turf/open/floor/rogue/grasscold,
/area/rogue/outdoors/warcamp/outskirts/decap)
"K" = (
/obj/item/reagent_containers/food/snacks/crow{
	dir = 8
	},
/turf/open/floor/rogue/dirt/road,
/area/rogue/outdoors/warcamp/outskirts/decap)
"L" = (
/obj/item/reagent_containers/food/snacks/crow{
	dir = 4
	},
/turf/open/floor/rogue/grasscold,
/area/rogue/outdoors/warcamp/outskirts/decap)
"M" = (
/turf/open/floor/rogue/dirt,
/area/rogue/outdoors/warcamp/outskirts/decap)
"N" = (
/obj/structure/flora/roguetree/pine/dead,
/turf/open/floor/rogue/dirt/road,
/area/rogue/outdoors/warcamp/outskirts/decap)
"O" = (
/obj/structure/flora/roguegrass,
/obj/structure/fluff/railing/border/east,
/turf/open/floor/rogue/grasscold,
/area/rogue/outdoors/warcamp/outskirts/decap)
"P" = (
/obj/structure/roguewindow/stained/zizo,
/turf/closed/wall/mineral/rogue/stonebrick,
/area/rogue/outdoors/warcamp/outskirts/decap)
"Q" = (
/obj/effect/baseturf_helper,
/turf/closed/mineral/rogue/bedrock,
/area/rogue/indoors/warcamp/outskirts/decap)
"R" = (
/obj/machinery/light/roguestreet{
	pixel_y = 11;
	pixel_x = -8;
	dir = 1
	},
/turf/open/floor/rogue/metal/barograte,
/area/rogue/outdoors/warcamp/outskirts/decap)
"S" = (
/obj/structure/fluff/railing/border{
	dir = 1
	},
/obj/item/roguecoin/aalloy/pile,
/turf/open/floor/rogue/dirt/road,
/area/rogue/outdoors/warcamp/outskirts/decap)
"T" = (
/obj/item/reagent_containers/food/snacks/crow{
	dir = 8;
	pixel_y = -9;
	pixel_x = 8
	},
/turf/open/floor/rogue/grasscold,
/area/rogue/outdoors/warcamp/outskirts/decap)
"U" = (
/obj/structure/flora/roguetree/pine/dead,
/turf/open/floor/rogue/grasscold,
/area/rogue/outdoors/warcamp/outskirts/decap)
"V" = (
/obj/structure/fluff/traveltile/warband/outskirts_to_intermission,
/turf/open/floor/rogue/cobblerock,
/area/rogue/outdoors/warcamp/outskirts/decap)
"W" = (
/turf/closed/wall/mineral/rogue/stonebrick,
/area/rogue/outdoors/warcamp/outskirts/decap)
"X" = (
/obj/structure/fluff/railing/border{
	dir = 5
	},
/obj/item/roguecoin/aalloy/pile,
/turf/open/floor/rogue/dirt/road,
/area/rogue/outdoors/warcamp/outskirts/decap)
"Y" = (
/obj/structure/flora/roguetree/pine,
/turf/open/floor/rogue/grasscold,
/area/rogue/outdoors/warcamp/outskirts/decap)
"Z" = (
/obj/structure/fluff/statue/gargoyle,
/turf/open/floor/rogue/church,
/area/rogue/outdoors/warcamp/outskirts/decap)

(1,1,1) = {"
r
r
r
s
s
M
M
A
A
A
M
M
A
A
A
A
A
M
s
s
s
s
r
r
r
r
r
r
r
r
r
r
s
s
M
M
A
A
A
r
r
r
r
r
r
"}
(2,1,1) = {"
r
r
s
s
s
s
M
j
M
M
s
s
M
M
M
j
M
s
s
s
c
M
s
r
r
r
r
r
r
s
s
s
s
M
M
A
N
A
A
A
r
r
r
r
r
"}
(3,1,1) = {"
r
r
s
s
s
s
s
s
s
s
s
s
s
s
s
M
s
s
s
M
A
M
M
M
M
r
r
s
s
s
s
s
M
M
M
M
A
A
A
M
M
r
r
r
r
"}
(4,1,1) = {"
r
s
s
s
s
s
s
s
s
s
s
M
M
M
s
s
s
M
M
M
A
a
U
a
a
M
M
M
s
s
s
s
M
M
s
M
A
A
M
M
a
a
a
r
r
"}
(5,1,1) = {"
s
s
s
s
s
s
s
s
M
M
M
A
A
A
M
M
M
M
U
A
A
A
A
A
a
a
a
j
M
M
s
s
s
s
s
M
M
M
U
a
a
D
D
a
r
"}
(6,1,1) = {"
s
s
s
s
s
M
M
M
M
A
A
A
N
A
A
A
A
A
A
A
A
A
A
M
M
M
A
A
A
A
M
s
s
s
M
M
M
a
a
D
D
D
D
D
a
"}
(7,1,1) = {"
s
s
s
s
M
M
W
W
W
X
A
A
A
A
A
A
A
A
A
A
M
M
M
a
a
M
M
A
M
M
M
M
M
M
M
M
v
a
D
D
D
D
D
D
D
"}
(8,1,1) = {"
s
M
M
M
N
A
P
Z
H
S
o
A
A
A
A
A
A
A
M
M
M
a
Y
a
a
a
M
A
M
j
M
A
A
M
M
v
v
D
D
v
h
h
h
h
h
"}
(9,1,1) = {"
s
s
s
s
A
A
W
W
W
w
A
A
A
A
A
A
M
M
M
a
a
a
a
D
v
a
M
M
A
M
M
A
M
a
a
a
D
a
a
e
p
p
p
p
p
"}
(10,1,1) = {"
s
M
M
s
s
A
A
A
M
A
A
M
M
M
M
M
M
a
a
a
v
D
D
D
D
v
a
a
A
E
A
M
a
a
D
v
a
x
A
E
E
E
A
A
A
"}
(11,1,1) = {"
s
A
E
M
M
s
A
A
A
A
A
M
a
a
t
a
a
a
v
v
v
D
D
D
D
D
a
v
A
E
E
D
D
D
v
v
A
E
A
E
A
A
A
A
A
"}
(12,1,1) = {"
s
s
M
E
E
M
M
A
A
A
D
D
v
v
v
a
a
D
v
D
D
D
D
f
D
t
a
a
A
A
E
E
D
a
a
E
E
A
A
A
A
A
E
E
A
"}
(13,1,1) = {"
s
s
s
A
M
E
M
A
M
a
a
D
D
D
a
a
Y
D
D
D
D
D
v
D
D
D
v
a
D
D
A
E
E
A
E
E
E
A
M
M
M
A
A
A
V
"}
(14,1,1) = {"
M
s
s
s
E
E
M
M
M
M
a
a
v
D
D
D
D
D
D
D
D
D
D
D
D
D
D
a
a
D
a
B
E
E
E
E
A
M
a
a
a
a
M
K
V
"}
(15,1,1) = {"
M
B
M
s
s
M
E
E
A
A
A
e
a
D
D
a
v
a
a
D
a
D
D
D
D
D
a
a
a
T
a
I
A
A
E
A
A
a
a
t
v
a
a
A
V
"}
(16,1,1) = {"
a
I
a
v
M
A
A
E
A
E
A
A
h
a
a
a
a
v
a
a
Y
a
D
a
a
D
D
Y
a
a
a
n
E
E
E
A
M
a
v
a
a
a
M
A
V
"}
(17,1,1) = {"
v
n
v
A
A
E
E
A
A
E
E
A
p
h
h
h
a
a
a
a
a
v
v
a
a
a
a
a
A
A
E
E
E
E
E
E
A
M
a
v
a
M
A
A
V
"}
(18,1,1) = {"
v
a
A
E
E
A
A
A
A
A
E
E
E
p
p
p
i
O
h
h
i
z
h
h
i
h
A
A
A
E
E
A
D
v
v
E
E
A
M
e
M
A
A
E
A
"}
(19,1,1) = {"
a
A
A
A
E
A
a
a
J
a
A
A
E
E
E
A
p
p
p
p
p
p
p
p
p
p
A
E
E
E
D
D
D
D
v
A
E
E
E
A
A
A
E
A
A
"}
(20,1,1) = {"
C
E
E
A
A
A
a
a
v
y
a
A
A
A
A
A
A
E
E
K
E
E
E
E
E
E
E
E
D
D
D
D
D
D
a
J
E
A
E
E
E
E
A
A
a
"}
(21,1,1) = {"
C
A
A
A
A
a
a
v
v
v
a
R
v
v
a
A
A
A
A
E
E
E
E
A
A
q
A
a
D
D
D
a
D
D
D
a
a
a
G
G
G
G
G
a
a
"}
(22,1,1) = {"
u
A
A
a
a
a
v
t
a
a
a
v
a
L
v
a
v
G
G
G
G
G
G
G
G
a
a
a
a
a
a
v
v
D
D
D
D
a
k
b
F
k
k
a
a
"}
(23,1,1) = {"
u
a
d
a
a
a
a
a
a
a
D
D
D
D
D
D
v
k
k
k
m
k
k
F
m
v
r
r
v
D
a
a
v
a
D
D
D
D
D
D
D
D
D
D
D
"}
(24,1,1) = {"
a
a
a
a
a
D
D
D
D
a
f
D
D
D
D
D
D
D
D
D
D
Y
v
a
D
r
r
a
D
D
D
D
a
a
a
D
D
D
D
D
D
D
D
D
a
"}
(25,1,1) = {"
a
a
a
D
D
D
a
v
D
D
D
D
D
D
D
D
D
D
D
D
D
D
a
v
a
r
r
a
D
D
D
D
D
D
Y
a
D
D
D
D
D
D
v
a
a
"}
(26,1,1) = {"
r
r
D
a
a
Y
D
D
D
D
D
D
D
D
f
D
D
D
D
D
D
D
a
a
r
r
r
D
D
D
D
D
D
D
D
D
D
D
D
D
D
v
a
v
a
"}
(27,1,1) = {"
r
r
a
a
a
D
D
D
D
D
a
D
D
D
D
r
r
r
r
D
D
D
f
r
r
r
D
D
f
D
D
D
a
a
D
D
a
v
v
D
D
a
a
a
g
"}
(28,1,1) = {"
r
r
r
a
a
a
a
v
a
a
a
a
D
r
r
r
r
r
r
r
r
r
r
r
r
D
D
D
D
D
a
a
a
a
v
a
a
v
a
a
D
a
Y
a
g
"}
(29,1,1) = {"
r
r
r
r
a
a
a
Y
a
t
r
r
r
r
r
r
r
r
r
r
r
r
r
r
D
D
D
D
a
a
a
a
a
Y
v
v
t
a
a
a
D
D
D
g
g
"}
(30,1,1) = {"
Q
r
r
r
r
r
r
r
r
r
r
r
r
r
r
r
r
r
r
r
r
r
r
r
r
r
a
a
a
a
v
a
a
a
a
a
a
a
v
v
a
D
g
g
l
"}
