//MAP CONVERTED BY dmm2tgm.py THIS HEADER COMMENT PREVENTS RECONVERSION, DO NOT REMOVE
"a" = (
/turf/open/floor/rogue/dirt/road,
/area/rogue/outdoors/warcamp/outskirts/standard)
"b" = (
/obj/effect/decal/cobble/mossy{
	dir = 4
	},
/turf/open/floor/rogue/dirt/road,
/area/rogue/outdoors/warcamp/outskirts/standard)
"c" = (
/obj/structure/flora/newtree,
/turf/open/floor/rogue/grass,
/area/rogue/outdoors/warcamp/outskirts/standard)
"d" = (
/turf/open/floor/rogue/grassyel,
/area/rogue/outdoors/warcamp/outskirts/standard)
"e" = (
/obj/structure/flora/newbranch/leafless{
	dir = 1
	},
/turf/open/floor/rogue/grass,
/area/rogue/outdoors/warcamp/outskirts/standard)
"f" = (
/obj/effect/decal/cobble/mossy{
	dir = 10
	},
/turf/open/floor/rogue/dirt/road,
/area/rogue/outdoors/warcamp/outskirts/standard)
"g" = (
/obj/structure/flora/newbranch/leafless{
	dir = 8
	},
/turf/open/floor/rogue/grass,
/area/rogue/outdoors/warcamp/outskirts/standard)
"h" = (
/obj/effect/baseturf_helper,
/turf/closed/mineral/random/rogue,
/area/rogue/outdoors/warcamp/outskirts/standard)
"i" = (
/turf/open/floor/rogue/grass,
/area/rogue/indoors/warcamp/outskirts/standard)
"j" = (
/turf/open/floor/rogue/cobble/mossy,
/area/rogue/outdoors/warcamp/outskirts/standard)
"k" = (
/obj/machinery/light/rogue/lanternpost{
	dir = 1;
	pixel_x = -21;
	pixel_y = 19
	},
/turf/open/floor/rogue/dirt/road,
/area/rogue/outdoors/warcamp/outskirts/standard)
"l" = (
/obj/structure/fluff/traveltile/warband/outskirts_to_intermission,
/turf/open/floor/rogue/cobble/mossy,
/area/rogue/outdoors/warcamp/outskirts/standard)
"m" = (
/turf/open/floor/rogue/grass,
/area/rogue/outdoors/warcamp/outskirts/standard)
"n" = (
/turf/open/floor/rogue/naturalstone,
/area/rogue/outdoors/warcamp/outskirts/standard)
"o" = (
/turf/closed/mineral/random/rogue,
/area/rogue/outdoors/warcamp/outskirts/standard)
"q" = (
/obj/machinery/light/rogue/lanternpost{
	dir = 1
	},
/turf/open/floor/rogue/dirt/road,
/area/rogue/outdoors/warcamp/outskirts/standard)
"r" = (
/obj/effect/decal/cobble/mossy{
	dir = 9
	},
/turf/open/floor/rogue/dirt/road,
/area/rogue/outdoors/warcamp/outskirts/standard)
"s" = (
/obj/structure/flora/newbranch/leafless{
	dir = 1
	},
/turf/open/floor/rogue/grassyel,
/area/rogue/outdoors/warcamp/outskirts/standard)
"u" = (
/obj/effect/decal/cobble/mossy{
	dir = 9
	},
/turf/closed/mineral/random/rogue,
/area/rogue/outdoors/warcamp/outskirts/standard)
"v" = (
/turf/open/water/cleanshallow,
/area/rogue/outdoors/warcamp/outskirts/standard)
"w" = (
/obj/structure/flora/newbranch/leafless{
	dir = 8
	},
/turf/open/floor/rogue/grassyel,
/area/rogue/outdoors/warcamp/outskirts/standard)
"x" = (
/obj/structure/flora/newbranch/connector{
	dir = 1
	},
/turf/open/floor/rogue/grass,
/area/rogue/outdoors/warcamp/outskirts/standard)
"y" = (
/turf/closed/mineral/random/rogue,
/area/rogue/indoors/warcamp/outskirts/standard)
"z" = (
/obj/structure/flora/newbranch/leafless,
/turf/open/floor/rogue/grass,
/area/rogue/outdoors/warcamp/outskirts/standard)
"A" = (
/obj/structure/flora/ausbushes/ywflowers,
/turf/open/floor/rogue/grass,
/area/rogue/outdoors/warcamp/outskirts/standard)
"B" = (
/obj/structure/flora/roguegrass,
/obj/structure/flora/newbranch/leafless{
	dir = 1
	},
/turf/open/floor/rogue/grass,
/area/rogue/outdoors/warcamp/outskirts/standard)
"C" = (
/obj/structure/flora/ausbushes/ppflowers,
/turf/open/floor/rogue/grass,
/area/rogue/outdoors/warcamp/outskirts/standard)
"D" = (
/obj/effect/decal/cobble/mossy,
/turf/open/floor/rogue/dirt/road,
/area/rogue/outdoors/warcamp/outskirts/standard)
"E" = (
/obj/structure/flora/ausbushes/brflowers,
/turf/open/floor/rogue/grassyel,
/area/rogue/outdoors/warcamp/outskirts/standard)
"F" = (
/turf/open/floor/rogue/naturalstone,
/area/rogue/indoors/warcamp/outskirts/standard)
"G" = (
/obj/structure/flora/newtree,
/turf/open/floor/rogue/grassyel,
/area/rogue/outdoors/warcamp/outskirts/standard)
"H" = (
/obj/effect/baseturf_helper,
/turf/closed/mineral/random/rogue,
/area/rogue/indoors/warcamp/outskirts/standard)
"I" = (
/obj/structure/flora/roguegrass,
/turf/open/floor/rogue/grass,
/area/rogue/outdoors/warcamp/outskirts/standard)
"J" = (
/obj/structure/flora/newbranch/connector{
	dir = 1
	},
/turf/open/floor/rogue/grassyel,
/area/rogue/outdoors/warcamp/outskirts/standard)
"K" = (
/obj/effect/decal/cobble/mossy{
	dir = 6
	},
/turf/open/floor/rogue/dirt/road,
/area/rogue/outdoors/warcamp/outskirts/standard)
"L" = (
/obj/effect/decal/cobble/mossy{
	dir = 8
	},
/turf/open/floor/rogue/dirt/road,
/area/rogue/outdoors/warcamp/outskirts/standard)
"M" = (
/obj/structure/flora/newbranch/leafless{
	dir = 4
	},
/turf/open/floor/rogue/grassyel,
/area/rogue/outdoors/warcamp/outskirts/standard)
"N" = (
/obj/effect/particle_effect/smoke{
	lifetime = 14400
	},
/turf/open/water/cleanshallow,
/area/rogue/indoors/warcamp/outskirts/standard)
"O" = (
/obj/structure/fluff/traveltile/warband/outskirts_to_camp,
/turf/open/floor/rogue/cobble/mossy,
/area/rogue/outdoors/warcamp/outskirts/standard)
"P" = (
/turf/open/floor/rogue/dirt,
/area/rogue/outdoors/warcamp/outskirts/standard)
"R" = (
/obj/structure/flora/newbranch/leafless,
/turf/open/floor/rogue/grassyel,
/area/rogue/outdoors/warcamp/outskirts/standard)
"S" = (
/obj/structure/flora/ausbushes/brflowers,
/turf/open/floor/rogue/grass,
/area/rogue/outdoors/warcamp/outskirts/standard)
"T" = (
/obj/effect/particle_effect/smoke{
	lifetime = 14400
	},
/turf/open/water/cleanshallow,
/area/rogue/outdoors/warcamp/outskirts/standard)
"U" = (
/obj/structure/flora/ausbushes/ywflowers,
/obj/structure/flora/ausbushes/ppflowers,
/turf/open/floor/rogue/grass,
/area/rogue/outdoors/warcamp/outskirts/standard)
"V" = (
/obj/structure/flora/newbranch/leafless{
	dir = 4
	},
/turf/open/floor/rogue/grass,
/area/rogue/outdoors/warcamp/outskirts/standard)
"W" = (
/turf/open/water/cleanshallow,
/area/rogue/indoors/warcamp/outskirts/standard)
"X" = (
/obj/machinery/light/rogue/lanternpost{
	pixel_x = 19
	},
/turf/open/floor/rogue/dirt/road,
/area/rogue/outdoors/warcamp/outskirts/standard)
"Y" = (
/obj/machinery/light/rogue/lanternpost{
	dir = 1;
	pixel_x = -7;
	pixel_y = 19
	},
/turf/open/floor/rogue/dirt/road,
/area/rogue/outdoors/warcamp/outskirts/standard)
"Z" = (
/obj/structure/flora/roguegrass,
/turf/open/floor/rogue/grassyel,
/area/rogue/outdoors/warcamp/outskirts/standard)

(1,1,1) = {"
y
y
y
y
y
y
y
y
y
y
y
y
y
y
y
y
y
n
d
o
o
o
o
o
o
o
o
o
o
o
o
o
u
o
o
j
j
j
j
j
l
o
o
o
o
"}
(2,1,1) = {"
i
y
y
y
y
y
y
y
y
y
y
y
y
y
y
y
n
d
d
d
d
o
o
o
o
o
o
I
o
o
o
u
o
j
j
j
j
j
j
D
j
l
o
o
o
"}
(3,1,1) = {"
N
i
y
y
y
y
y
y
y
y
y
y
y
y
y
n
d
d
d
d
Z
s
x
c
o
o
m
m
o
r
j
j
j
j
j
b
b
K
a
q
m
l
o
o
o
"}
(4,1,1) = {"
N
W
i
y
y
y
y
y
y
y
y
y
y
y
y
n
d
d
Z
d
m
m
m
m
m
m
m
a
r
j
j
j
j
j
b
a
a
a
m
m
d
I
o
o
o
"}
(5,1,1) = {"
N
W
W
i
i
y
y
y
y
y
y
y
y
y
y
n
d
d
Z
m
d
c
m
m
m
m
a
L
j
j
j
j
K
a
a
a
m
m
d
d
Z
I
d
o
o
"}
(6,1,1) = {"
N
W
W
W
W
i
i
y
y
y
y
y
y
y
n
d
d
d
d
m
m
m
m
m
m
X
L
j
j
j
j
b
a
a
d
d
d
m
d
I
m
d
d
I
G
"}
(7,1,1) = {"
N
W
W
W
v
v
i
i
y
y
y
y
y
n
d
d
d
d
m
d
m
I
c
z
a
r
j
j
j
b
k
a
a
d
d
m
m
I
d
d
d
G
s
J
c
"}
(8,1,1) = {"
y
W
W
W
v
v
v
v
m
i
y
y
n
d
d
d
c
z
d
d
I
m
m
a
r
j
j
j
b
a
a
m
d
d
m
m
I
d
c
m
d
d
m
Z
c
"}
(9,1,1) = {"
y
y
i
i
v
v
v
v
v
m
m
y
d
d
m
d
V
m
d
m
m
a
a
r
j
j
j
b
a
a
m
m
m
m
d
d
d
d
d
d
d
m
d
m
G
"}
(10,1,1) = {"
y
y
y
y
i
m
v
v
v
v
m
m
E
m
d
d
d
I
m
m
a
a
j
j
j
j
b
a
m
m
m
m
m
m
m
I
m
c
z
m
G
R
c
m
d
"}
(11,1,1) = {"
y
y
y
y
y
i
m
m
v
v
v
m
m
C
m
m
m
I
m
a
r
j
j
j
K
b
a
m
m
m
I
d
Z
m
m
m
m
m
m
m
m
d
d
m
I
"}
(12,1,1) = {"
y
y
y
y
y
y
y
m
m
v
v
v
v
m
A
m
m
a
a
a
j
j
j
b
a
a
m
d
d
d
w
d
Z
B
c
z
Z
d
G
d
Z
m
d
Z
m
"}
(13,1,1) = {"
y
y
y
y
y
y
y
y
m
C
v
v
v
v
v
A
S
a
a
a
j
j
a
k
a
m
m
d
d
d
c
m
m
m
M
d
d
d
M
d
d
s
G
m
g
"}
(14,1,1) = {"
y
y
y
y
y
y
y
y
y
m
A
v
v
v
v
v
P
P
a
a
a
a
a
m
m
m
d
d
m
m
m
m
m
d
d
m
C
A
S
m
m
m
m
m
c
"}
(15,1,1) = {"
y
y
y
y
y
y
y
y
y
d
m
A
S
v
v
v
v
P
P
a
a
m
m
m
m
m
I
I
e
c
m
d
G
R
m
A
S
v
v
v
v
C
A
m
m
"}
(16,1,1) = {"
y
y
y
y
y
y
n
d
d
d
a
a
S
C
v
v
v
v
P
m
A
m
m
e
c
m
I
m
m
m
d
d
d
m
m
C
v
v
v
v
v
v
S
m
c
"}
(17,1,1) = {"
y
y
y
n
n
n
d
d
Z
m
m
a
A
S
P
v
v
v
C
A
m
d
d
Z
V
m
m
m
m
d
d
d
m
m
S
v
v
v
v
v
v
v
v
S
c
"}
(18,1,1) = {"
y
y
y
n
d
G
d
w
m
d
m
a
a
P
P
P
v
v
v
S
m
d
m
d
d
I
m
m
d
d
n
n
A
C
v
v
v
v
v
v
v
v
v
C
c
"}
(19,1,1) = {"
y
y
n
d
d
d
s
c
m
d
a
a
a
a
P
P
v
v
v
A
m
m
d
d
m
m
d
d
d
n
y
y
v
v
v
v
y
y
v
v
v
v
v
U
c
"}
(20,1,1) = {"
y
y
d
d
G
m
m
d
d
a
r
j
f
a
a
A
C
v
v
v
m
m
d
d
d
d
d
d
n
y
y
v
v
v
y
y
y
y
y
y
v
v
v
S
m
"}
(21,1,1) = {"
y
n
d
Z
m
m
I
a
a
r
j
j
j
a
A
m
A
v
v
v
S
m
m
Z
d
d
n
n
y
y
W
W
v
v
y
y
y
y
y
y
v
v
v
C
A
"}
(22,1,1) = {"
n
d
d
I
m
d
a
r
j
j
j
j
D
a
d
d
S
v
v
v
v
S
m
m
d
n
y
y
y
y
W
W
W
y
y
y
y
y
y
y
y
v
v
v
S
"}
(23,1,1) = {"
d
d
m
m
I
a
r
j
j
j
j
a
a
m
d
d
d
A
v
v
v
C
m
I
n
y
y
y
y
y
W
W
W
y
y
y
y
y
y
y
y
v
v
v
T
"}
(24,1,1) = {"
f
a
a
m
X
r
j
j
j
j
k
a
d
d
m
d
d
m
S
v
v
v
v
m
y
y
y
y
y
y
W
W
W
F
y
y
y
y
y
y
y
v
v
v
T
"}
(25,1,1) = {"
j
j
f
a
r
j
j
j
j
a
a
m
m
d
m
m
m
d
m
S
v
v
v
v
y
y
y
y
W
W
W
W
F
F
F
y
y
y
y
y
y
y
v
v
T
"}
(26,1,1) = {"
j
j
j
j
j
j
j
j
a
a
m
d
m
I
m
d
G
R
d
d
m
v
v
v
y
y
y
W
W
W
W
W
F
F
F
F
y
y
y
y
y
y
y
v
T
"}
(27,1,1) = {"
d
j
j
j
j
j
Y
a
a
m
m
I
m
Z
d
d
M
d
n
n
y
y
v
v
W
y
y
W
W
W
W
W
F
F
F
F
y
y
y
y
y
y
y
y
T
"}
(28,1,1) = {"
o
I
I
j
j
f
a
m
d
d
G
d
d
d
n
n
n
n
y
y
y
y
y
W
W
W
y
W
W
W
W
F
F
F
F
F
y
y
y
y
y
y
y
y
y
"}
(29,1,1) = {"
o
Z
d
j
j
j
m
m
I
d
d
n
n
n
y
y
y
y
y
y
y
y
y
W
W
W
W
W
W
W
F
F
F
F
y
y
y
y
y
y
y
y
y
y
y
"}
(30,1,1) = {"
h
o
O
O
O
O
y
y
y
y
n
y
y
y
y
y
y
y
y
y
y
y
y
y
W
W
W
W
W
W
y
y
y
y
y
y
y
y
y
y
y
y
y
y
H
"}
