//MAP CONVERTED BY dmm2tgm.py THIS HEADER COMMENT PREVENTS RECONVERSION, DO NOT REMOVE
"be" = (
/obj/structure/flora/roguegrass/water/reeds,
/turf/open/floor/rogue/dirt,
/area/rogue/outdoors/warcamp/outskirts/terrorbog)
"bL" = (
/turf/open/floor/rogue/dirt/road,
/area/rogue/outdoors/warcamp/outskirts/terrorbog)
"ed" = (
/obj/structure/flora/roguegrass/water/reeds,
/obj/structure/flora/roguegrass/water/reeds,
/turf/open/water/swamp/deep,
/area/rogue/outdoors/warcamp/outskirts/terrorbog)
"ee" = (
/obj/structure/glowshroom/bright,
/turf/open/water/swamp,
/area/rogue/outdoors/warcamp/outskirts/terrorbog)
"hx" = (
/obj/structure/flora/roguegrass/water/reeds,
/obj/structure/glowshroom,
/turf/open/water/swamp/deep,
/area/rogue/outdoors/warcamp/outskirts/terrorbog)
"ju" = (
/obj/structure/flora/roguegrass,
/turf/open/floor/rogue/dirt/road,
/area/rogue/outdoors/warcamp/outskirts/terrorbog)
"kw" = (
/obj/structure/glowshroom/bright,
/turf/open/floor/rogue/dirt,
/area/rogue/outdoors/warcamp/outskirts/terrorbog)
"lG" = (
/turf/open/floor/rogue/twig,
/area/rogue/outdoors/warcamp/outskirts/terrorbog)
"lT" = (
/obj/structure/flora/roguegrass/water/reeds,
/obj/structure/glowshroom/bright{
	icon_state = "glowshroom2"
	},
/turf/open/water/swamp,
/area/rogue/outdoors/warcamp/outskirts/terrorbog)
"mb" = (
/obj/structure/flora/roguegrass/water/reeds,
/obj/structure/flora/roguegrass/maneater/real,
/turf/open/floor/rogue/dirt,
/area/rogue/outdoors/warcamp/outskirts/terrorbog)
"oa" = (
/obj/item/reagent_containers/glass/cup/skull,
/obj/item/rogueweapon/huntingknife/stoneknife,
/turf/open/floor/rogue/dirt/road,
/area/rogue/outdoors/warcamp/outskirts/terrorbog)
"ph" = (
/obj/structure/flora/roguegrass/water/reeds,
/obj/structure/flora/roguegrass/maneater/real,
/turf/open/water/swamp,
/area/rogue/outdoors/warcamp/outskirts/terrorbog)
"pN" = (
/obj/structure/glowshroom/bright{
	icon_state = "glowshroom2"
	},
/turf/open/floor/rogue/dirt/road,
/area/rogue/outdoors/warcamp/outskirts/terrorbog)
"rZ" = (
/obj/structure/glowshroom,
/turf/open/water/swamp/deep,
/area/rogue/outdoors/warcamp/outskirts/terrorbog)
"tr" = (
/obj/structure/flora/roguegrass/herb/symphitum,
/turf/open/floor/rogue/dirt/road,
/area/rogue/outdoors/warcamp/outskirts/terrorbog)
"tJ" = (
/obj/structure/glowshroom,
/turf/open/water/swamp,
/area/rogue/outdoors/warcamp/outskirts/terrorbog)
"tZ" = (
/obj/structure/flora/roguetree/wise{
	pixel_x = -10;
	pixel_y = -6
	},
/turf/open/floor/rogue/dirt/road,
/area/rogue/outdoors/warcamp/outskirts/terrorbog)
"yf" = (
/obj/structure/glowshroom/bright{
	icon_state = "glowshroom2"
	},
/turf/open/floor/rogue/dirt,
/area/rogue/outdoors/warcamp/outskirts/terrorbog)
"zb" = (
/obj/structure/fluff/traveltile/warband/outskirts_to_intermission,
/turf/open/floor/rogue/dirt/road,
/area/rogue/outdoors/warcamp/outskirts/terrorbog)
"zh" = (
/obj/structure/fluff/traveltile/warband/outskirts_to_camp,
/turf/open/floor/rogue/dirt/road,
/area/rogue/outdoors/warcamp/outskirts/terrorbog)
"zj" = (
/obj/structure/glowshroom/bright,
/turf/open/water/swamp/deep,
/area/rogue/outdoors/warcamp/outskirts/terrorbog)
"zk" = (
/obj/structure/flora/roguetree/burnt,
/turf/open/water/swamp/deep,
/area/rogue/outdoors/warcamp/outskirts/terrorbog)
"zD" = (
/obj/structure/flora/roguegrass/maneater/real,
/turf/open/water/swamp,
/area/rogue/outdoors/warcamp/outskirts/terrorbog)
"AC" = (
/obj/structure/glowshroom/bright{
	icon_state = "glowshroom2"
	},
/obj/structure/flora/roguegrass/water/reeds,
/obj/structure/flora/roguegrass/maneater/real,
/turf/open/water/swamp,
/area/rogue/outdoors/warcamp/outskirts/terrorbog)
"BJ" = (
/obj/structure/flora/roguegrass/water,
/turf/open/floor/rogue/dirt/road,
/area/rogue/outdoors/warcamp/outskirts/terrorbog)
"Cj" = (
/obj/structure/flora/roguegrass/water,
/turf/open/water/swamp,
/area/rogue/outdoors/warcamp/outskirts/terrorbog)
"Dy" = (
/obj/structure/flora/roguegrass/water/reeds,
/turf/open/water/swamp,
/area/rogue/indoors/warcamp/outskirts/terrorbog)
"DP" = (
/obj/structure/flora/roguegrass/water,
/obj/structure/flora/roguegrass/herb/atropa,
/turf/open/floor/rogue/dirt/road,
/area/rogue/outdoors/warcamp/outskirts/terrorbog)
"Fg" = (
/obj/structure/flora/roguegrass/water,
/obj/structure/flora/roguegrass/herb/symphitum,
/turf/open/floor/rogue/dirt/road,
/area/rogue/outdoors/warcamp/outskirts/terrorbog)
"Gi" = (
/obj/structure/flora/roguegrass/water/reeds,
/turf/open/water/swamp,
/area/rogue/outdoors/warcamp/outskirts/terrorbog)
"Hr" = (
/turf/closed/mineral/rogue/bedrock,
/area/rogue/outdoors/warcamp/outskirts/terrorbog)
"HU" = (
/obj/structure/flora/roguetree/burnt,
/turf/open/floor/rogue/dirt/road,
/area/rogue/outdoors/warcamp/outskirts/terrorbog)
"Iu" = (
/turf/open/water/swamp/deep,
/area/rogue/outdoors/warcamp/outskirts/terrorbog)
"IK" = (
/turf/open/floor/rogue/dirt,
/area/rogue/outdoors/warcamp/outskirts/terrorbog)
"JI" = (
/obj/structure/glowshroom,
/obj/structure/flora/roguegrass/water/reeds,
/turf/open/water/swamp,
/area/rogue/outdoors/warcamp/outskirts/terrorbog)
"Ko" = (
/obj/structure/flora/roguegrass/water/reeds,
/obj/structure/glowshroom,
/turf/open/water/swamp,
/area/rogue/outdoors/warcamp/outskirts/terrorbog)
"Kp" = (
/obj/structure/glowshroom/bright{
	icon_state = "glowshroom2"
	},
/turf/open/water/swamp/deep,
/area/rogue/outdoors/warcamp/outskirts/terrorbog)
"Ku" = (
/obj/structure/flora/roguegrass/water/reeds,
/turf/open/water/swamp/deep,
/area/rogue/outdoors/warcamp/outskirts/terrorbog)
"Lu" = (
/obj/structure/glowshroom,
/turf/open/floor/rogue/dirt/road,
/area/rogue/outdoors/warcamp/outskirts/terrorbog)
"LF" = (
/obj/structure/flora/roguetree/burnt,
/turf/open/floor/rogue/dirt,
/area/rogue/outdoors/warcamp/outskirts/terrorbog)
"LN" = (
/obj/structure/glowshroom{
	icon_state = "glowshroom2"
	},
/turf/open/water/swamp/deep,
/area/rogue/outdoors/warcamp/outskirts/terrorbog)
"Me" = (
/turf/open/water/swamp,
/area/rogue/outdoors/warcamp/outskirts/terrorbog)
"Mk" = (
/obj/structure/flora/roguetree/burnt,
/turf/open/water/swamp,
/area/rogue/outdoors/warcamp/outskirts/terrorbog)
"NC" = (
/obj/structure/flora/roguegrass/water/reeds,
/obj/structure/flora/roguegrass/water/reeds,
/turf/open/floor/rogue/dirt,
/area/rogue/outdoors/warcamp/outskirts/terrorbog)
"Qv" = (
/turf/open/floor/rogue/cobblerock,
/area/rogue/outdoors/warcamp/outskirts/terrorbog)
"QQ" = (
/obj/structure/flora/roguegrass/water,
/turf/open/water/swamp/deep,
/area/rogue/outdoors/warcamp/outskirts/terrorbog)
"Sy" = (
/obj/structure/flora/roguegrass/water/reeds,
/obj/structure/flora/roguegrass/maneater/real,
/turf/open/water/swamp/deep,
/area/rogue/outdoors/warcamp/outskirts/terrorbog)
"Uf" = (
/obj/structure/glowshroom/bright{
	icon_state = "glowshroom3"
	},
/turf/open/water/swamp/deep,
/area/rogue/outdoors/warcamp/outskirts/terrorbog)
"Ur" = (
/turf/closed/mineral/rogue/bedrock,
/area/rogue/indoors/warcamp/outskirts/terrorbog)
"VY" = (
/obj/effect/baseturf_helper,
/turf/closed/mineral/rogue/bedrock,
/area/rogue/indoors/warcamp/outskirts/terrorbog)
"Xn" = (
/obj/structure/flora/roguegrass/water/reeds,
/turf/open/floor/rogue/dirt/road,
/area/rogue/outdoors/warcamp/outskirts/terrorbog)
"Yv" = (
/obj/structure/flora/roguegrass/water/reeds,
/obj/effect/baseturf_helper,
/turf/open/water/swamp/deep,
/area/rogue/outdoors/warcamp/outskirts/terrorbog)
"YC" = (
/obj/structure/fluff/traveltile/warband/outskirts_to_camp,
/turf/open/floor/rogue/cobblerock,
/area/rogue/outdoors/warcamp/outskirts/terrorbog)
"Zn" = (
/obj/structure/glowshroom/bright{
	icon_state = "glowshroom2"
	},
/turf/open/water/swamp,
/area/rogue/outdoors/warcamp/outskirts/terrorbog)
"Zq" = (
/obj/structure/fluff/traveltile/warband/outskirts_to_intermission,
/turf/open/floor/rogue/twig,
/area/rogue/outdoors/warcamp/outskirts/terrorbog)

(1,1,1) = {"
VY
Ur
Ur
Ur
Ur
Ur
Ur
Ur
Ur
Ur
Ur
Ur
Ur
Ur
Ur
Ur
Ur
Ur
Ur
Ur
Ur
Ur
Ur
Ur
Ur
Ku
Ku
Ku
Ku
NC
be
Xn
be
Gi
Gi
Ko
Mk
Iu
Iu
Iu
tJ
Gi
Gi
hx
rZ
"}
(2,1,1) = {"
Ur
Ur
Ur
Ur
Ur
Ur
Ku
Ku
Ku
Ur
Ur
Ur
Ur
Ur
Ur
Ur
Ur
Ur
Ur
Ur
Ur
Ur
Ur
Ur
Ur
Ku
Me
Iu
lG
Iu
lG
lG
Ko
Ko
Me
Ko
Ku
Ku
Ku
Me
Gi
Gi
IK
Gi
rZ
"}
(3,1,1) = {"
Ur
Ur
Ur
Ur
Ku
Gi
Ku
Iu
Ko
Ku
Ur
Ur
Ur
Ur
Ur
Ur
Ur
Ur
Ur
Ur
Ur
Ur
Ur
Ur
Ku
Me
Me
Iu
Iu
Gi
Gi
IK
Gi
Me
Iu
Iu
Ku
Iu
Ku
Gi
Ko
IK
IK
Gi
Ku
"}
(4,1,1) = {"
Ur
Ur
Ur
be
Iu
Iu
Iu
zk
Iu
Ku
Ur
Ur
Ur
Ur
Ur
Ur
Ur
Ur
Ur
Ur
Ur
Ur
Ur
Ku
Me
Iu
Ku
HU
Iu
Me
Gi
lG
Gi
Me
rZ
Iu
Ku
Ku
Mk
Me
Gi
IK
IK
IK
Ku
"}
(5,1,1) = {"
Ur
Ur
be
be
IK
Iu
LN
Iu
IK
Me
Gi
Gi
Ur
Ur
Ur
Ur
Ur
Ur
Ur
Ur
Ur
Ur
Ku
Iu
Iu
hx
Iu
Kp
yf
Iu
Iu
lG
Ku
Ku
Iu
rZ
Iu
Ku
Iu
Me
Gi
IK
IK
IK
Hr
"}
(6,1,1) = {"
Ur
be
IK
Me
Me
Me
IK
Uf
Iu
Iu
Me
Me
Ku
Ur
Ur
Ur
Ur
Ur
Ur
Ur
Ur
Ur
Gi
Me
Ku
bL
Iu
IK
IK
Ku
hx
lG
lG
lG
Iu
Iu
zk
Ku
Iu
Me
Gi
Gi
IK
Hr
Hr
"}
(7,1,1) = {"
Ur
be
Me
Me
Mk
Gi
Gi
IK
Iu
Iu
zk
Me
Iu
Gi
Ku
Ur
Ur
Ur
Ur
Ur
Ku
Ku
Iu
Iu
Ku
Lu
IK
IK
Me
zk
Ku
Ku
Gi
IK
Gi
Me
Iu
Ku
Iu
Me
Me
Gi
Hr
Hr
Hr
"}
(8,1,1) = {"
Ur
Gi
Me
Me
be
JI
Gi
Gi
mb
be
Ku
Iu
Iu
Ku
Me
Ku
Ku
Ku
Ku
Ku
Iu
Me
Ku
Sy
bL
Me
Me
Me
kw
Iu
Iu
Me
Gi
IK
Gi
Gi
Gi
Ku
Ku
Mk
Me
Gi
Hr
Hr
Hr
"}
(9,1,1) = {"
be
Gi
Gi
be
be
IK
IK
Me
Me
Me
be
be
Gi
Gi
Me
IK
tr
BJ
BJ
Ku
Ku
Ku
Ku
Iu
Me
IK
IK
IK
IK
Iu
zk
Me
Gi
lG
IK
Gi
Me
Iu
Ku
Gi
Gi
Gi
Me
Hr
Hr
"}
(10,1,1) = {"
Hr
Me
IK
IK
IK
bL
IK
IK
bL
Me
Me
Me
Zn
IK
IK
bL
bL
bL
BJ
tr
BJ
Iu
Iu
Me
Me
IK
IK
Kp
Iu
zD
Me
Gi
Gi
IK
IK
IK
Me
Gi
Iu
Iu
Gi
LF
IK
Hr
Hr
"}
(11,1,1) = {"
Hr
Hr
IK
HU
bL
bL
bL
LF
IK
IK
IK
IK
Me
Me
bL
bL
bL
bL
bL
bL
bL
Me
Iu
Iu
IK
IK
Iu
Iu
IK
IK
IK
zj
zD
Me
bL
IK
Me
Iu
Iu
Iu
IK
IK
IK
Hr
Hr
"}
(12,1,1) = {"
Hr
Hr
IK
bL
bL
bL
IK
IK
Me
IK
bL
bL
bL
bL
bL
bL
Qv
bL
bL
Qv
bL
tr
Iu
Iu
Iu
Iu
IK
IK
IK
IK
IK
IK
IK
Me
IK
lG
IK
Me
Ku
bL
bL
bL
bL
Hr
Hr
"}
(13,1,1) = {"
Hr
IK
bL
bL
bL
IK
IK
ee
Me
bL
bL
tr
bL
bL
bL
BJ
Qv
bL
bL
bL
Qv
bL
bL
Iu
Iu
Iu
Iu
IK
IK
IK
IK
bL
bL
Iu
Xn
IK
IK
lG
Ku
bL
bL
bL
bL
bL
Hr
"}
(14,1,1) = {"
Hr
HU
bL
IK
IK
IK
IK
Me
bL
bL
bL
bL
bL
ju
Qv
Qv
Qv
Qv
Qv
bL
Qv
bL
bL
bL
Iu
Iu
Iu
Iu
Iu
Iu
bL
bL
bL
bL
bL
bL
be
Xn
ju
bL
bL
bL
bL
bL
zb
"}
(15,1,1) = {"
Hr
Hr
IK
IK
bL
bL
Me
Me
bL
bL
bL
Qv
bL
Qv
Qv
Qv
Qv
bL
Qv
Qv
bL
bL
ju
bL
bL
bL
Qv
Qv
bL
Qv
Qv
Qv
bL
Qv
Qv
Qv
bL
bL
Qv
bL
bL
bL
lG
bL
Zq
"}
(16,1,1) = {"
Hr
bL
Me
Me
Me
Me
Me
Qv
bL
Qv
Qv
Qv
Qv
Qv
bL
bL
bL
bL
Qv
Qv
Qv
Qv
bL
bL
Qv
bL
Qv
bL
bL
bL
bL
bL
bL
Qv
bL
bL
Qv
bL
bL
Qv
lG
bL
bL
lG
Zq
"}
(17,1,1) = {"
Hr
Hr
Me
Qv
Qv
bL
bL
bL
bL
bL
Qv
Qv
Qv
Qv
bL
bL
tZ
oa
bL
Qv
Qv
Qv
Qv
bL
bL
bL
bL
bL
bL
bL
bL
Qv
bL
bL
Qv
Qv
Qv
Qv
lG
lG
lG
lG
lG
bL
Zq
"}
(18,1,1) = {"
Hr
Hr
Hr
bL
bL
Qv
bL
bL
Qv
Qv
Qv
Qv
Qv
Qv
Qv
ju
bL
bL
Qv
Qv
Qv
Qv
Qv
bL
Qv
Qv
Qv
bL
bL
Qv
bL
bL
Qv
Qv
Qv
bL
bL
bL
Qv
lG
bL
lG
bL
lG
zb
"}
(19,1,1) = {"
Hr
Hr
Qv
bL
bL
bL
bL
Qv
bL
bL
Qv
Qv
bL
bL
Qv
Qv
bL
Qv
Qv
Qv
Qv
bL
bL
bL
bL
bL
bL
bL
bL
bL
bL
bL
bL
bL
bL
bL
bL
bL
lG
bL
bL
bL
bL
bL
zb
"}
(20,1,1) = {"
Hr
Hr
bL
bL
bL
bL
bL
bL
bL
bL
bL
bL
bL
bL
BJ
Qv
Qv
Qv
Qv
ju
Qv
bL
bL
bL
bL
ju
Iu
Iu
Iu
Iu
Iu
Iu
IK
Me
Me
IK
IK
Me
bL
bL
lG
bL
bL
bL
Hr
"}
(21,1,1) = {"
Hr
Qv
bL
bL
bL
Qv
bL
bL
bL
IK
IK
bL
bL
bL
bL
bL
Qv
bL
DP
Qv
BJ
bL
bL
bL
bL
bL
Iu
Iu
ee
Me
Me
Me
IK
IK
IK
Me
Iu
bL
HU
bL
bL
bL
bL
bL
Hr
"}
(22,1,1) = {"
zh
bL
bL
bL
bL
bL
IK
IK
IK
bL
IK
IK
Me
Cj
bL
bL
BJ
bL
bL
bL
bL
bL
bL
bL
Iu
Iu
Iu
Iu
Me
Me
be
Gi
be
be
Me
HU
bL
tr
Xn
bL
lG
lG
bL
Hr
Hr
"}
(23,1,1) = {"
zh
bL
Qv
bL
bL
bL
IK
bL
bL
Me
Me
Iu
ee
Iu
QQ
bL
bL
Qv
Fg
bL
bL
tr
bL
Kp
Iu
zj
Iu
Me
be
be
Iu
Iu
be
IK
be
Xn
Xn
Xn
Gi
lG
lG
Gi
be
Hr
Hr
"}
(24,1,1) = {"
zh
Qv
bL
bL
Qv
bL
IK
bL
bL
Kp
Me
Iu
Ku
Iu
Iu
Iu
Iu
bL
BJ
bL
bL
Iu
Iu
zj
Iu
Iu
bL
Xn
Xn
Me
Me
Me
be
bL
Me
Me
Me
IK
IK
lG
be
be
Me
Hr
Hr
"}
(25,1,1) = {"
YC
bL
bL
bL
bL
bL
tr
Me
Me
Ku
Ku
lT
Me
Gi
Ku
Ku
Ku
Sy
Ku
Iu
Kp
Iu
Iu
Iu
Me
Me
Gi
Ku
Me
bL
Xn
be
Gi
Me
bL
IK
IK
Me
IK
IK
Iu
bL
bL
Hr
Hr
"}
(26,1,1) = {"
zh
Qv
bL
bL
bL
Iu
Me
Me
Gi
Ku
Me
Ku
Gi
Ur
Ur
Ur
Ur
Ur
Ur
Dy
Gi
Me
Me
Me
Me
Iu
Iu
Me
Me
Me
Ku
bL
bL
Me
Me
Iu
IK
lG
Me
IK
Me
Me
bL
Hr
Hr
"}
(27,1,1) = {"
zh
bL
bL
bL
Me
Ku
Gi
ph
Ku
Gi
Ku
Ur
Ur
Ur
Ur
Ur
Ur
Ur
Ur
Ur
Ur
Gi
Me
IK
Iu
zk
Me
IK
IK
IK
Gi
Mk
lG
IK
lG
Me
Me
IK
Iu
Me
Iu
Iu
Me
Iu
Hr
"}
(28,1,1) = {"
zh
bL
bL
Me
Me
Gi
Me
Me
Gi
Gi
Ur
Ur
Ur
Ur
Ur
Ur
Ur
Ur
Ur
Ur
Ur
Ur
be
IK
IK
Iu
Iu
IK
IK
IK
lG
lG
Me
lG
lG
Iu
Iu
Me
Me
Me
Iu
IK
IK
Ku
Ku
"}
(29,1,1) = {"
Hr
Hr
Me
Gi
Gi
Ku
Iu
Ku
ed
Ur
Ur
Ur
Ur
Ur
Ur
Ur
Ur
Ur
Ur
Ur
Ur
Ur
Ur
be
IK
Iu
Iu
Me
Me
IK
AC
Iu
Iu
Iu
Iu
Me
IK
IK
Ku
be
be
IK
Kp
Iu
Ku
"}
(30,1,1) = {"
Hr
Hr
Hr
Gi
Gi
Iu
Ku
Gi
Ur
Ur
Ur
Ur
Ur
Ur
Ur
Ur
Ur
Ur
Ur
Ur
Ur
Ur
Ur
be
Iu
Me
pN
bL
IK
Me
Gi
Me
Gi
Gi
Ku
be
be
be
be
IK
Ku
Ku
Ku
Ku
Yv
"}
