//MAP CONVERTED BY dmm2tgm.py THIS HEADER COMMENT PREVENTS RECONVERSION, DO NOT REMOVE
"a" = (
/turf/open/floor/rogue/dirt/road,
/area/rogue)
"n" = (
/turf/open/water/cleanshallow,
/area/rogue)
"v" = (
/turf/closed/mineral/rogue/bedrock,
/area/rogue)
"V" = (
/turf/open/floor/rogue/grassred,
/area/rogue)

(1,1,1) = {"
n
n
n
v
v
v
v
v
v
v
v
v
v
v
v
a
a
V
V
V
a
a
a
a
a
a
a
"}
(2,1,1) = {"
n
n
n
a
a
v
v
v
v
v
v
v
v
v
v
a
V
V
V
V
a
a
a
a
a
a
a
"}
(3,1,1) = {"
n
n
n
n
n
a
a
v
v
v
v
v
v
v
a
V
V
V
V
a
a
a
a
a
a
a
a
"}
(4,1,1) = {"
n
n
n
n
n
n
a
a
v
v
v
v
v
a
a
V
V
V
a
a
a
a
a
a
a
a
a
"}
(5,1,1) = {"
v
n
a
n
n
n
n
n
a
a
v
v
a
a
V
V
V
a
a
a
a
a
a
a
a
a
a
"}
(6,1,1) = {"
v
v
a
a
n
n
n
n
n
a
a
v
a
a
V
V
a
a
a
a
a
a
a
a
a
a
a
"}
(7,1,1) = {"
v
v
v
v
a
a
n
n
n
n
a
a
a
V
V
a
a
a
a
a
a
a
a
a
a
a
a
"}
(8,1,1) = {"
v
v
v
v
v
a
a
n
n
n
n
a
a
V
V
a
a
a
a
a
a
a
a
a
a
a
a
"}
(9,1,1) = {"
v
v
v
v
v
v
v
a
n
n
n
n
a
V
V
a
a
a
a
a
a
a
a
a
a
a
a
"}
(10,1,1) = {"
v
v
v
v
v
v
v
v
a
n
n
n
n
V
a
a
a
a
a
a
a
a
a
a
a
a
a
"}
(11,1,1) = {"
v
v
v
v
v
v
v
v
v
a
n
n
n
n
a
a
a
a
a
a
a
a
a
a
a
a
a
"}
(12,1,1) = {"
v
v
v
v
v
v
v
v
v
a
a
n
n
n
a
a
a
a
a
a
a
a
a
a
a
a
a
"}
(13,1,1) = {"
v
v
v
v
v
v
a
a
a
a
a
a
n
n
n
a
a
a
a
a
a
a
a
a
a
a
v
"}
(14,1,1) = {"
v
v
a
a
a
a
a
V
V
a
a
a
a
n
n
n
a
a
a
a
a
a
a
a
a
a
v
"}
(15,1,1) = {"
v
a
a
a
a
a
V
V
V
V
a
a
a
n
n
n
a
a
a
a
a
a
a
a
a
a
v
"}
(16,1,1) = {"
a
a
a
a
V
V
V
V
V
V
a
a
a
a
n
n
n
a
a
a
a
a
a
a
a
v
v
"}
(17,1,1) = {"
a
a
a
V
V
V
V
V
V
V
V
a
a
a
a
n
n
n
a
a
a
a
a
a
v
v
v
"}
(18,1,1) = {"
a
a
V
V
V
V
V
V
V
V
V
V
a
a
a
a
n
n
n
a
a
a
a
a
v
v
v
"}
(19,1,1) = {"
a
V
V
V
V
V
V
V
V
V
V
V
a
a
a
a
a
n
n
n
n
a
a
v
v
v
v
"}
(20,1,1) = {"
a
V
V
V
V
V
V
V
V
V
V
V
V
a
a
a
a
a
n
n
n
n
a
v
v
v
v
"}
(21,1,1) = {"
a
V
V
V
V
V
V
V
V
V
V
V
V
a
a
a
a
a
a
n
n
n
n
v
v
v
v
"}
(22,1,1) = {"
a
V
V
V
V
V
V
V
V
V
V
V
V
a
a
a
a
a
a
a
n
n
n
n
v
v
v
"}
(23,1,1) = {"
a
V
V
V
V
V
V
V
V
V
V
V
V
a
a
a
a
a
a
a
a
n
n
n
v
v
v
"}
(24,1,1) = {"
a
a
V
V
V
V
V
V
V
V
V
V
a
a
a
a
a
a
a
a
v
v
n
n
n
v
v
"}
(25,1,1) = {"
a
a
V
V
V
V
V
V
V
V
V
a
a
a
a
a
a
a
v
v
v
v
v
n
n
n
v
"}
(26,1,1) = {"
a
a
a
a
a
a
V
V
V
V
a
a
a
a
v
v
v
v
v
v
v
v
v
n
n
n
n
"}
(27,1,1) = {"
a
a
a
a
a
a
a
a
a
a
a
v
v
v
v
v
v
v
v
v
v
v
v
v
n
n
n
"}
