//MAP CONVERTED BY dmm2tgm.py THIS HEADER COMMENT PREVENTS RECONVERSION, DO NOT REMOVE
"a" = (
/obj/structure/fluff/traveltile/warband/outskirts_to_intermission,
/turf/open/floor/rogue/AzureSand,
/area/rogue/outdoors/warcamp/outskirts/coast)
"b" = (
/obj/structure/fluff/railing/border{
	dir = 1
	},
/obj/structure/stairs{
	dir = 8
	},
/turf/open/floor/rogue/wood,
/area/rogue/indoors/warcamp/outskirts/coast)
"d" = (
/turf/open/water/ocean,
/area/rogue/outdoors/warcamp/outskirts/coast)
"f" = (
/turf/closed/wall/mineral/rogue/wooddark,
/area/rogue/indoors/warcamp/outskirts/coast)
"g" = (
/turf/open/floor/rogue/AzureSand,
/area/rogue/outdoors/warcamp/outskirts/coast)
"h" = (
/turf/open/floor/rogue/dirt,
/area/rogue/outdoors/warcamp/outskirts/coast)
"j" = (
/turf/open/floor/rogue/dirt,
/area/rogue/indoors/warcamp/outskirts/coast)
"l" = (
/obj/machinery/light/rogue/firebowl/stump,
/turf/open/floor/rogue/dirt/road,
/area/rogue/indoors/warcamp/outskirts/coast)
"n" = (
/obj/structure/flora/roguegrass/water,
/turf/open/floor/rogue/AzureSand,
/area/rogue/outdoors/warcamp/outskirts/coast)
"o" = (
/obj/structure/flora/roguegrass{
	name = "tangled seaweed"
	},
/turf/open/floor/rogue/naturalstone,
/area/rogue/indoors/warcamp/outskirts/coast)
"q" = (
/obj/structure/fluff/railing/border,
/obj/structure/stairs{
	dir = 8
	},
/turf/open/floor/rogue/wood,
/area/rogue/indoors/warcamp/outskirts/coast)
"r" = (
/obj/structure/flora/roguegrass,
/turf/open/floor/rogue/AzureSand,
/area/rogue/indoors/warcamp/outskirts/coast)
"t" = (
/turf/open/floor/rogue/AzureSand,
/area/rogue/indoors/warcamp/outskirts/coast)
"u" = (
/turf/open/water/ocean/deep,
/area/rogue/outdoors/warcamp/outskirts/coast)
"v" = (
/obj/machinery/light/rogue/firebowl/stump,
/turf/open/floor/rogue/naturalstone{
	color = "#d8d8d8"
	},
/area/rogue/indoors/warcamp/outskirts/coast)
"w" = (
/turf/open/floor/rogue/dirt/road,
/area/rogue/outdoors/warcamp/outskirts/coast)
"y" = (
/turf/open/floor/rogue/dirt/road{
	color = "#d8d8d8"
	},
/area/rogue/indoors/warcamp/outskirts/coast)
"z" = (
/turf/open/floor/rogue/AzureSand{
	color = "#d8d8d8"
	},
/area/rogue/outdoors/warcamp/outskirts/coast)
"A" = (
/obj/structure/flora/roguegrass,
/turf/open/floor/rogue/AzureSand,
/area/rogue/outdoors/warcamp/outskirts/coast)
"B" = (
/obj/structure/flora/roguegrass{
	name = "tangled seaweed"
	},
/turf/open/floor/rogue/naturalstone{
	color = "#d8d8d8"
	},
/area/rogue/indoors/warcamp/outskirts/coast)
"D" = (
/turf/open/floor/rogue/naturalstone{
	color = "#d8d8d8"
	},
/area/rogue/indoors/warcamp/outskirts/coast)
"E" = (
/obj/structure/flora/roguegrass{
	name = "tangled seaweed"
	},
/turf/open/floor/rogue/dirt,
/area/rogue/indoors/warcamp/outskirts/coast)
"I" = (
/turf/open/water/ocean{
	color = "#d8d8d8"
	},
/area/rogue/outdoors/warcamp/outskirts/coast)
"K" = (
/obj/effect/baseturf_helper,
/turf/open/water/ocean/deep,
/area/rogue/outdoors/warcamp/outskirts/coast)
"M" = (
/turf/closed/mineral/rogue/bedrock,
/area/rogue/indoors/warcamp/outskirts/coast)
"N" = (
/turf/closed/wall/mineral/rogue/wooddark,
/area/rogue/outdoors/warcamp/outskirts/coast)
"P" = (
/turf/open/floor/rogue/dirt{
	color = "#d8d8d8"
	},
/area/rogue/indoors/warcamp/outskirts/coast)
"Q" = (
/turf/open/floor/rogue/dirt/road,
/area/rogue/indoors/warcamp/outskirts/coast)
"R" = (
/turf/open/water/ocean/deep{
	color = "#d8d8d8"
	},
/area/rogue/outdoors/warcamp/outskirts/coast)
"X" = (
/obj/effect/baseturf_helper,
/turf/closed/mineral/rogue/bedrock,
/area/rogue/indoors/warcamp/outskirts/coast)
"Y" = (
/turf/open/floor/rogue/naturalstone,
/area/rogue/indoors/warcamp/outskirts/coast)
"Z" = (
/obj/structure/fluff/traveltile/warband/outskirts_to_camp,
/turf/open/floor/rogue/AzureSand,
/area/rogue/outdoors/warcamp/outskirts/coast)

(1,1,1) = {"
X
M
M
M
M
M
M
M
M
M
M
M
M
M
M
M
M
M
M
M
M
M
M
M
M
M
M
M
M
M
M
M
M
M
M
M
M
M
M
M
M
M
M
M
M
"}
(2,1,1) = {"
M
M
M
M
M
M
M
M
M
M
M
M
M
M
M
M
M
M
M
M
M
M
M
M
M
M
M
M
M
M
M
M
M
M
M
M
M
M
M
M
M
M
M
M
M
"}
(3,1,1) = {"
M
M
M
M
M
M
M
M
M
M
M
M
M
o
h
o
E
M
M
M
M
M
M
M
M
M
M
M
M
M
M
M
M
M
M
M
M
M
M
M
M
M
M
M
M
"}
(4,1,1) = {"
M
M
M
M
M
M
M
M
M
M
o
o
w
w
g
w
w
o
E
M
M
M
M
M
M
M
M
M
M
M
M
M
M
M
M
M
M
M
M
M
M
M
M
M
M
"}
(5,1,1) = {"
M
M
M
M
M
M
M
o
o
j
w
w
g
A
g
g
g
w
w
Q
M
M
M
M
M
M
M
M
M
M
M
M
M
M
M
M
M
M
Y
j
M
M
M
M
M
"}
(6,1,1) = {"
M
M
M
M
M
M
o
w
w
g
g
g
g
g
g
g
g
g
A
g
h
y
M
M
M
M
M
M
M
M
M
M
v
f
b
q
f
l
Q
Q
Y
M
M
M
M
"}
(7,1,1) = {"
M
M
M
M
o
w
w
g
g
g
g
g
g
g
g
g
g
g
g
g
g
y
B
B
B
B
M
M
M
B
B
B
Q
g
z
z
g
g
g
g
Q
j
Y
M
M
"}
(8,1,1) = {"
M
M
o
w
w
A
g
g
g
A
g
g
g
g
A
g
g
g
g
g
g
g
Q
Q
Q
j
M
D
Q
Q
Q
Q
g
g
z
z
A
g
g
g
g
g
w
j
M
"}
(9,1,1) = {"
M
w
w
g
g
g
g
g
g
g
g
g
g
g
g
g
g
g
A
g
g
g
g
t
r
Q
D
D
Q
t
t
g
g
g
z
z
g
g
g
g
g
g
g
g
w
"}
(10,1,1) = {"
w
A
g
g
g
g
g
g
g
g
g
g
g
g
g
g
g
g
g
g
g
g
g
t
Q
Q
D
D
Q
t
g
g
g
g
z
z
g
g
g
g
g
g
g
g
g
"}
(11,1,1) = {"
Z
g
g
g
g
g
g
g
g
g
g
g
g
g
g
g
g
g
g
g
g
g
A
t
y
D
D
D
Q
t
g
g
g
N
z
z
N
g
g
g
g
A
g
g
g
"}
(12,1,1) = {"
Z
g
g
g
g
g
g
g
g
g
g
g
g
g
g
g
g
g
g
w
w
w
Q
Q
Q
D
D
D
Q
t
g
g
g
g
z
z
g
g
g
g
g
g
g
g
a
"}
(13,1,1) = {"
Z
g
g
g
g
g
g
g
g
g
g
A
g
g
g
g
w
w
Q
D
D
D
D
j
Y
Y
D
y
Q
t
t
g
g
g
z
z
g
g
g
g
g
g
g
g
a
"}
(14,1,1) = {"
Z
g
g
g
g
g
g
g
g
g
g
g
g
g
g
w
Q
B
B
M
M
M
M
Y
Y
M
D
j
Q
Q
Q
t
t
g
z
z
g
g
g
g
g
g
g
g
a
"}
(15,1,1) = {"
Z
g
g
g
g
g
g
A
g
g
g
g
g
w
w
B
M
M
M
M
M
M
M
M
M
M
M
B
o
D
Q
Q
t
A
z
z
g
g
g
g
g
g
g
g
a
"}
(16,1,1) = {"
Z
g
g
g
g
g
g
g
g
g
A
g
g
w
D
D
B
B
B
B
B
M
M
M
M
M
M
M
M
B
D
Q
Q
N
z
z
N
g
g
g
g
g
g
g
a
"}
(17,1,1) = {"
w
w
w
g
g
g
n
g
g
g
g
g
g
g
w
w
w
w
Q
Q
Q
D
D
M
M
M
M
M
M
M
B
B
Q
g
z
z
g
g
g
g
g
g
g
g
a
"}
(18,1,1) = {"
Y
Y
Y
w
w
w
g
g
g
g
g
g
g
g
A
g
g
g
g
g
g
g
Q
D
D
M
B
B
B
B
B
D
Q
g
z
z
g
g
g
g
g
g
g
g
a
"}
(19,1,1) = {"
M
M
Y
Y
Y
Y
w
g
g
A
g
g
g
g
g
g
g
g
g
g
g
g
g
j
D
D
j
Q
Q
Q
Q
Q
g
g
z
z
g
g
g
g
g
A
g
g
g
"}
(20,1,1) = {"
M
M
M
M
Y
Y
Y
h
g
g
g
g
g
g
g
g
g
g
g
g
g
g
g
j
D
D
Q
t
t
t
g
g
g
g
z
z
g
g
g
g
g
g
g
g
g
"}
(21,1,1) = {"
M
M
M
M
M
M
Y
h
d
d
d
d
d
g
g
g
g
g
A
g
g
g
g
Q
D
D
Q
t
t
g
g
A
g
N
z
z
N
g
g
g
g
g
g
d
d
"}
(22,1,1) = {"
M
M
M
M
M
M
Y
w
d
d
d
d
d
d
d
g
g
g
g
g
g
g
g
Q
D
Q
t
t
g
g
g
g
g
g
z
z
g
g
g
g
g
d
d
d
d
"}
(23,1,1) = {"
M
M
M
M
o
Y
Y
w
d
u
u
d
d
d
d
d
d
d
d
g
g
g
w
Q
D
P
t
g
g
g
g
g
g
g
z
z
d
d
d
d
d
d
d
u
u
"}
(24,1,1) = {"
M
M
M
o
Y
h
w
d
u
u
u
u
u
d
d
d
u
u
d
d
d
w
D
B
B
Y
h
d
d
d
d
d
d
d
I
I
d
d
d
d
u
u
u
u
u
"}
(25,1,1) = {"
M
M
o
Y
w
d
d
u
u
u
u
u
u
u
u
u
u
u
u
u
d
w
B
M
M
B
h
d
u
u
d
d
d
d
R
R
u
u
u
u
u
u
u
u
u
"}
(26,1,1) = {"
M
M
o
j
w
d
u
u
u
u
u
u
u
u
u
u
u
u
u
d
w
B
M
M
M
B
Q
d
u
u
u
u
u
N
R
R
N
u
u
u
u
u
u
u
u
"}
(27,1,1) = {"
M
o
o
j
d
u
u
u
u
u
u
u
u
u
u
u
u
u
u
d
Q
B
M
M
M
B
Q
d
d
u
u
u
u
u
R
R
u
u
u
u
u
u
u
u
u
"}
(28,1,1) = {"
M
M
o
Y
w
d
u
u
u
u
u
u
u
u
u
u
u
u
u
d
Q
B
M
M
M
B
Q
d
d
u
u
u
u
u
u
u
u
u
u
u
u
u
u
u
u
"}
(29,1,1) = {"
M
M
M
o
Y
w
d
u
u
u
u
u
u
u
u
u
u
u
u
d
j
B
M
M
B
B
Q
d
d
u
u
u
u
u
u
u
u
u
u
u
u
u
u
u
u
"}
(30,1,1) = {"
M
M
M
M
o
w
d
u
u
u
u
u
u
u
u
u
u
u
d
d
j
B
M
M
B
P
Q
d
d
u
u
u
u
u
u
u
u
u
u
u
u
u
u
u
K
"}
